wwwwwwwwwwwwwwwwwwwwwww
w.....................w
w.....................w
wm.m.m.m.m.m.m.m.m.m.mw
wm.m.m.m.m.m.m.m.m.m.mw
wm.m.m.m.m.m.m.m.m.m.mw
wm.m.b.m.m.m.m.m.b.m.mw
wm.m.m.b.m.m.m.b.m.m.mw
wm.m.m.m.b.m.b.m.m.m.mw
wm.m.m.m.m.b.m.m.m.m.mw
w.....................w
w.....................w
w.....................w
w.....................w
w.....................w
w.....................w
w.....................w
w.....................w
w..........A..........w
w.....................w