wwwwwwwwwwwwwwwwwwwwwww
w.....................w
w.....................w
wn....m.m.....m.m.....w
wm.m.m.m.m...m.m.m.m.nw
wnm.m.m.m.m.m.m.m.m.m.w
wm.m.m.m.m.m.m.m.m.m.nw
w..........n..........w
w.....................w
w.....................w
w.....................w
w.....................w
w.....................w
w.....................w
w.....................w
w.....................w
w.....................w
w.....................w
w..........A..........w
w.....................w