wwwwwwwwwwwwwwwwwwwwwww
w..m.m.m.m............w
w..m.m.m.m............w
w.....................w
w.....................w
w.....................w
w.....................w
w.....................w
w.....................w
w.....................w
wb.b.b.b.b.b.b.b.b....w
w.....................w
w.....................w
w.....................w
w.....................w
w.....................w
w.....................w
w.....................w
w..........A..........w
w.....................w