wwwwwwwwwwwwwwwwwwwwwww
w.....................w
w.....................w
w.....................w
w.....................w
w......m.m.m.m.m......w
w......m.m.m.m.m......w
w......m.m.m.m.m......w
w......m.m.m.m.m......w
w......m.m.m.m.m......w
w......b.b.b.b.b......w
w.....................w
w.....................w
w.....................w
w.....................w
w.....................w
w.....................w
w.....................w
w..........A..........w
w.....................w