wwwwwwwwwwwwwwwwwwwwwww
w.....................w
w.....................w
w.....................w
w.....................w
w.....................w
w..m.m.m.m.m.m.m.m.m..w
w..m.m.b.b.b.b.b.m.m..w
w..m.m.m.m.m.m.m.m.m..w
w..m.m.m.m.m.m.m.m.m..w
w.....................w
w.....................w
w.....................w
w.....................w
w.....................w
w.....................w
w.....................w
w.....................w
w..........A..........w
w.....................w