wwwwwwwwwwwwwwwwwwwwwww
w.....................w
w.....................w
w.....................w
w.....................w
w.....................w
w..m.m.m.m.m.m.m.m.m..w
w..m.b.b.b.b.b.b.b.m..w
w..m.b.m.m.m.m.m.b.m..w
w..m.b.m.m.m.m.m.b.m..w
w.....................w
w.....................w
w.....................w
w.....................w
w.....................w
w.....................w
w.....................w
w.....................w
w..........A..........w
w.....................w