tcfc..ccct
+sss..sss+
x........x
+........+
xcc.cccccx
+........+
x........x
+........+
xss.sssssx
+........+
x........x
+........+
x........x
+........+
x....A...x