tsfs.sssst
+ccc..ccc+
x........x
+........+
xss.sssssx
+........+
x..c.....x
+........+
x........x
+cc.ccccc+
x......s.x
+........+
x..c.....x
+........+
x....A...x